[
  {
    "type": "mapgen",
    "om_terrain": [ "isekai_cabin_small_1" ],
    "object": {
      "fill_ter": "t_floor",
      "rows": [
        "........................",
        "........................",
        "........................",
        "........................",
        "......---------------...",
        "......-~~~~~~~~~~~~~-...",
        "......-~~~~~~~~~~~~~-...",
        "......-~~##########~-...",
        "......-~~#        #~-...",
        "......G~~=        #~-...",
        "......-~~# RR     #~-...",
        "......-~~#####    #~-...",
        "......-~~#   =    #~-...",
        "......-~~#   #    #~-...",
        "......-~~##########~-...",
        "......-~~~~~~~~~~~~~-...",
        "......---------------...",
        "........................",
        "........................",
        "........................",
        "........................",
        "........................",
        "........................",
        "........................"
      ],
      "palettes": [ "isekai_cabin_palette_common" ]
    }
  },
  {
    "type": "mapgen",
    "om_terrain": [ "isekai_cabin_small_roof_1" ],
    "object": {
      "fill_ter": "t_floor",
      "rows": [
        "                        ",
        "                        ",
        "                        ",
        "                        ",
        "                        ",
        "                        ",
        "                        ",
        "         ..........     ",
        "         ..........     ",
        "         ..........     ",
        "         ..........     ",
        "         ..........     ",
        "         ..........     ",
        "         ..........     ",
        "         ..........     ",
        "                        ",
        "                        ",
        "                        ",
        "                        ",
        "                        ",
        "                        ",
        "                        ",
        "                        ",
        "                        "
      ],
      "palettes": [ "roof_palette" ],
      "terrain": { ".": "t_isekai_shingle_flat_roof" }
    }
  }
]
