[
  {
    "type": "mapgen",
    "om_terrain": [ "isekai_cabin_small_1" ],
    "object": {
      "fill_ter": "t_floor",
      "rows": [
        "........................",
        "........................",
        "........................",
        "........................",
        "......---------------...",
        "......-~~~~~~~~~~~~~-...",
        "......-~~~~~~~~~~~~~-...",
        "......-~~##########~-...",
        "....__-~~#        #~-...",
        "..____G~~=        #~-...",
        "______-~~# RR     #~-...",
        "_____.-~~#####    #~-...",
        "____..-~~#   =    #~-...",
        "__....-~~#   #    #~-...",
        "......-~~##########~-...",
        "......-~~~~~~~~~~~~~-...",
        "......---------------...",
        "........................",
        "........................",
        "........................",
        "........................",
        "........................",
        "........................",
        "........................"
      ],
      "palettes": [ "isekai_cabin_palette_common" ]
    }
  },
  {
    "type": "mapgen",
    "om_terrain": [ "isekai_cabin_small_roof_1" ],
    "object": {
      "fill_ter": "t_floor",
      "rows": [
        "                        ",
        "                        ",
        "                        ",
        "                        ",
        "                        ",
        "                        ",
        "                        ",
        "         ..........     ",
        "         ..........     ",
        "         ..........     ",
        "         ..........     ",
        "         ..........     ",
        "         ..........     ",
        "         ..........     ",
        "         ..........     ",
        "                        ",
        "                        ",
        "                        ",
        "                        ",
        "                        ",
        "                        ",
        "                        ",
        "                        ",
        "                        "
      ],
      "palettes": [ "roof_palette" ],
      "terrain": { ".": "t_isekai_shingle_flat_roof" }
    }
  },
  {
    "type": "mapgen",
    "om_terrain": [ "isekai_house_basic_1_1x1" ],
    "object": {
      "fill_ter": "t_floor",
      "rows": [
        "........................",
        "........................",
        "..--------------------..",
        "..-.......~~~~~~~~~..-..",
        "..-......~I#I###I#I~.-..",
        "..-......~#RR  |RR#~.-..",
        "..-......~I    |  I~.-..",
        "..-.....~~#=||||=|#~.-..",
        "..-....~~~#       #~~-..",
        "..-...~~~~=       #~~-..",
        "..-..~~~~~#       #~~-..",
        "..-~~~~~~~II|||   #~~-..",
        "..G~~~~~.~~#  =   #~.-..",
        "..-~~~...~~#  |   I~.-..",
        "..-......~~#RR|   #~.-..",
        "..-......~~I#I##I#I~.-..",
        "..-.......~~~~~~~~~~.-..",
        "..-..................-..",
        "..-..................-..",
        "..-..................-..",
        "..-..................-..",
        "..--------------------..",
        "........................",
        "........................"
      ],
      "palettes": [ "isekai_cabin_palette_common" ]
    }
  },
  {
    "type": "mapgen",
    "om_terrain": [ "isekai_house_basic_1_1x1_roof" ],
    "object": {
      "fill_ter": "t_floor",
      "rows": [
        "                        ",
        "                        ",
        "                        ",
        "                        ",
        "          .........     ",
        "          .........     ",
        "          .........     ",
        "          .........     ",
        "          .........     ",
        "          .........     ",
        "          .........     ",
        "          .........     ",
        "           ........     ",
        "           ........     ",
        "           ........     ",
        "           ........     ",
        "                        ",
        "                        ",
        "                        ",
        "                        ",
        "                        ",
        "                        ",
        "                        ",
        "                        "
      ],
      "palettes": [ "roof_palette" ],
      "terrain": { ".": "t_isekai_shingle_flat_roof" }
    }
  }
]
